IBAN;Booked At;Text;Credit/Debit Amount;Balance;Valuta Date
CH3480808004661205482;2021-06-03 00:00:00.0;Gutschrift Jahn-Holderegger M. und Moser;30000;30000;2021-06-03 00:00:00.0
CH3480808004661205482;2021-06-07 00:00:00.0;Bancomat Bezug BKB Burgf.-Plz 13 05.06.2021, 17:08, V PAY-Karten-Nr. 61045028;-200;29800;2021-06-07 00:00:00.0
CH3480808004661205482;2021-06-08 00:00:00.0;Gutschrift TWINT von HOLDEREGGER, SUZANNE;30;29830;2021-06-08 00:00:00.0
CH3480808004661205482;2021-06-08 00:00:00.0;Einkauf BAUHAUS Fachcentren 07.06.2021, 11:37, V PAY-Karten-Nr. 61045028;-27.3;29802.7;2021-06-08 00:00:00.0
CH3480808004661205482;2021-06-10 00:00:00.0;Einkauf Coop-1948 BS Spale 09.06.2021, 14:41, V PAY-Karten-Nr. 61045028;-11.65;29791.05;2021-06-10 00:00:00.0
CH3480808004661205482;2021-06-11 00:00:00.0;E-Banking Auftrag an Vock / Holderegger;-2500;27291.05;2021-06-11 00:00:00.0
CH3480808004661205482;2021-06-14 00:00:00.0;Einkauf Bahnhofkiosk 12.06.2021, 15:07, V PAY-Karten-Nr. 61045028;-3.2;27287.85;2021-06-14 00:00:00.0
